11111111111111111111111111111
10000000000000000000000000001
10000000000000000000P00000001
10000000000000000000000000001
10000000000000000000000000001
10000000000000000000000000001
10000000000000001111111111111
1000000000C000000000000000001
11111111111111111110000000001
10000000000000000000000000001
10000000000000000000000000001
1000000000000000C000000000001
10000000000000000000000000001
11111111111111111111111111111
