11111111111111
1000E000000001
10000000000001
1C000000000001
100000000000C1
1000P0C0000001
11111111111111
