111111
10C001
10C001
1P01C1
101E01
111111
