111111
1NC001
10C001
1P11N1
100E01
111111
