11111
10C01
10C01
10PE1
10001
11111
