111111
101001
1P0C01
1010E1
111111
