111111
101001
1P1C01
1010E1
111111
